                                    CCCCCCCCCCCCCCCCCCCCCCCCCCCCCCCCCCCCCCCCCCCCCCC                                       CCCCCCCCCCCCCCCCCCC
          CCCCCCCCCCCCCCCCCCCCCCCCCCC     C     k? m   e     CCCC meC       b=  WCC                                       CCCCCC         A  W
          C                               C                   CCC   C       a   WCC                                     CCCC     Z       Br W
WCCCCCCCCC   Z      Z                                W         CC   C           WCC                                     CC              WWWWW
W                        Z     Z        W      Z     W   ?      C   C           WCCCCCCCCCCCCCCCCCCCCCCCCCCCCCCCCCCCCCCC           T WWWWWWWW
W            W  ?   ?              W    W            W                                                                    Z       WWWWWWWWWW
W    Z      WW  WW  ?              W    WW           W       ?          Z          Z          Z        Z         Z           T WWWWWWWWW     
W    M     WWWM WWW ??   A     W   W    WW     A     W          K    M M M M        M               M  M  M     M  M        WWWWWWWW
W P       ?WWW EWWWW??   Br    W     T  WWW    Br    W          K             T ?     E            ?  E  E KK E  ? E     WWWWWWWWW
WFFFFFFFFFFFFFFFFFFFFFFFFFFFFFFFFFFFFFFFFFFFFFFFFFFFFF          FFFFFFFFFFFFFFFFFFFFFFFFFFFF      FFFFFFFFFFFFFFFFFFFFFFFFFFFFFF
                                                      ++++++++++                            ++++++
                                                                              